##############
#oo....##..$$#
#oo....##..$$#
#..##..xx..###
#..##..xx..###
#..xx..##..###
#ooxx..##oo###
#..........###
#..........###
#..#####...###
#..##......###
#@@###########
##############
