#############
#......##..$#
#......####$#
#..##......##
#####......##
#....####..##
#......##..##
#..xx..xx..##
#..xx..xx..##
#..##...#..##
#..##...#..##
#@@##########
#############
