##############
#......##..$$#
#......####$$#
#..##......###
#####......###
#....####..###
#......##..###
#..xx..xx..###
#..xx..xx..###
#..##...#..###
#..##...#..###
#@@###########
##############
