########
#####$$#
#####$$#
#......#
#......#
#oo..oo#
#oo..oo#
#oo..oo#
#oo..oo#
#......#
#......#
#@@#####
########
