######
#$$###
#..###
#..ww#
#....#
#ww..#
#....#
######
#..###
#@@###
######
