######
#$$###
#$$###
#..###
#....#
#...w#
#...w#
#...w#
#..###
#..###
#@@###
######
