########
#####$$#
#####$$#
#......#
#......#
#oo..oo#
#oo..oo#
#..oooo#
#..oooo#
#.....0#
#......#
#@@#####
########
