########
###$$###
###..###
###..###
#......#
#......#
#oo..oo#
#oo..oo#
#..oooo#
#..oooo#
#..00..#
#......#
###..###
###..###
###@@###
########
