########
###$$###
###..###
###..###
#......#
#......#
#oooooo#
#oooooo#
#..oooo#
#..oooo#
#..0...#
#......#
###..###
###..###
###@@###
########
