###########..###
###########..###
###########..#.$
####oo...##..#.$
####.....##..###
####.....##..###
####oo.........#
..##...........#
..##..##########
...#..##########
...#..##########
####..##########
####..##########
####..##########
####@@##########
