###########..###
###########..###
###########....$
####oo...##....$
####.....##..###
####...w.##..###
####oo.w.......#
..##...w.......#
..##..##########
......##########
......##########
####..##########
####..##########
####..##########
####@@##########
