##################
############..####
##################
############....$#
#####.....##....$#
#####.....##..####
#####...w.########
#####...w..o....##
#..##...w..o....##
#..##..###########
#......###########
#......###########
#####..###########
#####..###########
#####..###########
#####@@###########
##################
