###########..###
###########..###
###########..#.$
####ww...##..#.$
####.....##..###
####.....##..###
####ww.........#
..##...........#
..##..##########
...#..##########
...#..##########
####..##########
####..##########
####..##########
####@@##########
