##################
############..####
############..####
############..#.$#
#####ww...##..#.$#
#####.....##..####
#####.....##..####
#####ww.........##
#..##...........##
#..##..###########
#...#..###########
#...#..###########
#####..###########
#####..###########
#####..###########
#####@@###########
##################
