###########..###
################
###########....$
####.....##....$
####.....##..###
####...w.#######
####...w.......#
..##...w.......#
..##..##########
......##########
......##########
####..##########
####..##########
####..##########
####@@##########
