###################
############..#####
############..#####
############..#.$$#
#####ww...##..#.$$#
#####.....##..#####
#####.....##..#####
#####ww.........###
#..##...........###
#..##..############
#...#..############
#...#..############
#####..############
#####..############
#####..############
#####@@############
###################
