##################
############..####
############..####
############....$#
#####ww...##....$#
#####.....##..####
#####...w.##..####
#####ww.w.......##
#..##...w.......##
#..##..###########
#......###########
#......###########
#####..###########
#####..###########
#####..###########
#####@@###########
##################
