##############
#######$$#####
#######$$#####
#######..#####
#######......#
#######......#
#oooooooooo..#
#oooooooooo..#
#oo......oo..#
#oo......oo..#
#oo..oo......#
#oo..oo......#
#oo..oooooooo#
#oo..oooooooo#
#......#######
#......#######
#..###########
#@@###########
##############
