##############
#######$$#####
#######..#####
#######......#
#######......#
#oooooooooooo#
#oooooooooooo#
#oo....oooooo#
#oo....oooooo#
#oooooooo....#
#oooooooo....#
#oo..oooooooo#
#oo..oooooooo#
#......#######
#......#######
#..###########
#@@###########
##############
