##############
#######$$#####
#######..#####
#######......#
#######......#
#oooooooooo..#
#oooooooooo..#
#oooooo..oo..#
#oooooo..oo..#
#oo..oo..oooo#
#oo..oo..oooo#
#oooooooooooo#
#oooooooooooo#
#......#######
#......#######
#..###########
#@@###########
##############
