##########
#####$$###
#####..###
#..##..###
#..##..###
#........#
#........#
#..#######
#@@#######
##########
