####$$##
####..##
..##..##
..##..##
..#.....
..#.....
..######
@@######
