####$$##
####..##
..##..##
..##..##
........
........
..######
@@######
