##########
####$$####
####$$####
#........#
#..#..#..#
#........#
###....###
#........#
#..#..#..#
#........#
##########
#........#
#..#..#..#
#........#
#..#..#..#
#........#
#..#..#..#
#........#
#..#..#..#
#........#
####@@####
##########
