##############
#####ww#######
#####..#######
##############
#.........o.$#
#.........o.$#
#########..###
#..######ww###
#.......#..###
#.......#..###
#####..#######
#####@@#######
##############
