####ww######
####..######
####..######
...........$
...........$
..######..##
..######ww##
..........##
..........##
####..######
####@@######
