###############
#####ww########
#####..########
#####..########
#...........$$#
#...........$$#
#..######..####
#..######ww####
#..........####
#..........####
#####..########
#####@@########
###############
