####ww######
####..######
############
.........o.$
.........o.$
########..##
..######ww##
.......#..##
.......#..##
####..######
####@@######
