##############
#####$$#######
#####..#######
#####..#######
#......#....$#
#......#....$#
#..######..###
#..######..###
#..#.......###
#..#.......###
#####..#######
#####@@#######
##############
