###############
#####..########
#####..########
#####..########
#......#....$$#
#......#....$$#
#..######..####
#..######..####
#..#.......####
#..#.......####
#####..########
#####@@########
###############
