####$$######
####..######
####..######
......#....$
......#....$
..######..##
..######..##
..#.......##
..#.......##
####..######
####@@######
