###############
#####ww########
#####..########
###############
#.........o.$$#
#.........o.$$#
#########..####
#..######ww####
#.......#..####
#.......#..####
#####..########
#####@@########
###############
