##############
#####ww#######
#####..#######
#####..#######
#...........$#
#...........$#
#..######..###
#..######ww###
#..........###
#..........###
#####..#######
#####@@#######
##############
